"filename", "language", "TypeScript", "CSS", "comment", "blank", "total"
"/Users/rock/Documents/Projekti/2dGame/client/src/Level/LevelLogic/Enemy/Asteroid.ts", "TypeScript", 78, 0, 0, 14, 92
"/Users/rock/Documents/Projekti/2dGame/client/src/Level/LevelLogic/Enemy/Enemy.ts", "TypeScript", 183, 0, 6, 22, 211
"/Users/rock/Documents/Projekti/2dGame/client/src/Level/LevelLogic/Enemy/EnemyBoss.ts", "TypeScript", 13, 0, 0, 2, 15
"/Users/rock/Documents/Projekti/2dGame/client/src/Level/LevelLogic/Enemy/EnemySpawner.ts", "TypeScript", 276, 0, 3, 50, 329
"/Users/rock/Documents/Projekti/2dGame/client/src/Level/LevelLogic/Game UI/Hud.ts", "TypeScript", 217, 0, 12, 30, 259
"/Users/rock/Documents/Projekti/2dGame/client/src/Level/LevelLogic/Game UI/InGameMenu.ts", "TypeScript", 308, 0, 2, 28, 338
"/Users/rock/Documents/Projekti/2dGame/client/src/Level/LevelLogic/Game UI/PowerUp.ts", "TypeScript", 253, 0, 3, 33, 289
"/Users/rock/Documents/Projekti/2dGame/client/src/Level/LevelLogic/Other/AnimationLoop.ts", "TypeScript", 25, 0, 1, 8, 34
"/Users/rock/Documents/Projekti/2dGame/client/src/Level/LevelLogic/Other/Sounds.ts", "TypeScript", 67, 0, 0, 14, 81
"/Users/rock/Documents/Projekti/2dGame/client/src/Level/LevelLogic/Other/canvasLogic.ts", "TypeScript", 30, 0, 33, 9, 72
"/Users/rock/Documents/Projekti/2dGame/client/src/Level/LevelLogic/Player/Player.ts", "TypeScript", 229, 0, 2, 22, 253
"/Users/rock/Documents/Projekti/2dGame/client/src/Level/LevelLogic/Player/PlayerInput.ts", "TypeScript", 191, 0, 14, 17, 222
"/Users/rock/Documents/Projekti/2dGame/client/src/Level/LevelLogic/Player/PlayerSpells.ts", "TypeScript", 403, 0, 8, 55, 466
"/Users/rock/Documents/Projekti/2dGame/client/src/Level/LevelLogic/Player/Projectile.ts", "TypeScript", 226, 0, 2, 31, 259
"/Users/rock/Documents/Projekti/2dGame/client/src/Level/LevelLogic/Sprite/LevelImages.ts", "TypeScript", 20, 0, 7, 8, 35
"/Users/rock/Documents/Projekti/2dGame/client/src/Level/LevelLogic/Sprite/Sprite.ts", "TypeScript", 39, 0, 9, 6, 54
"/Users/rock/Documents/Projekti/2dGame/client/src/Level/LevelLogic/Sprite/Vector.ts", "TypeScript", 8, 0, 0, 1, 9
"/Users/rock/Documents/Projekti/2dGame/client/src/Level/LevelLogic/mainLevelLogic.ts", "TypeScript", 132, 0, 26, 26, 184
"/Users/rock/Documents/Projekti/2dGame/client/src/Level/levelGenerator.ts", "TypeScript", 10, 0, 0, 5, 15
"/Users/rock/Documents/Projekti/2dGame/client/src/Level/levelStyling.css", "CSS", 0, 915, 12, 107, 1034
"/Users/rock/Documents/Projekti/2dGame/client/src/MainMenu/Leaderboards.ts", "TypeScript", 54, 0, 0, 12, 66
"/Users/rock/Documents/Projekti/2dGame/client/src/MainMenu/LevelSelection/LevelSelectionGenerator.ts", "TypeScript", 24, 0, 0, 9, 33
"/Users/rock/Documents/Projekti/2dGame/client/src/MainMenu/LevelSelection/LevelSelectionLogic.ts", "TypeScript", 31, 0, 0, 8, 39
"/Users/rock/Documents/Projekti/2dGame/client/src/MainMenu/LevelSelection/LevelSelectionStyling.css", "CSS", 0, 112, 1, 23, 136
"/Users/rock/Documents/Projekti/2dGame/client/src/MainMenu/MainMenu.ts", "TypeScript", 157, 0, 5, 28, 190
"/Users/rock/Documents/Projekti/2dGame/client/src/MainMenu/MainMenuGenerator.ts", "TypeScript", 25, 0, 0, 5, 30
"/Users/rock/Documents/Projekti/2dGame/client/src/MainMenu/MainMenuLogic.ts", "TypeScript", 190, 0, 11, 48, 249
"/Users/rock/Documents/Projekti/2dGame/client/src/MainMenu/MainMenuStyling.css", "CSS", 0, 401, 13, 56, 470
"/Users/rock/Documents/Projekti/2dGame/client/src/MainMenu/Settings.ts", "TypeScript", 49, 0, 1, 9, 59
"/Users/rock/Documents/Projekti/2dGame/client/src/Stores/LevelStore.ts", "TypeScript", 73, 0, 0, 12, 85
"/Users/rock/Documents/Projekti/2dGame/client/src/Stores/MenuStore.ts", "TypeScript", 46, 0, 0, 9, 55
"/Users/rock/Documents/Projekti/2dGame/client/src/Utils/IconsExports.ts", "TypeScript", 15, 0, 0, 4, 19
"/Users/rock/Documents/Projekti/2dGame/client/src/Utils/OftenUsed.ts", "TypeScript", 28, 0, 0, 5, 33
"/Users/rock/Documents/Projekti/2dGame/client/src/Utils/TsTypes.ts", "TypeScript", 190, 0, 0, 24, 214
"/Users/rock/Documents/Projekti/2dGame/client/src/index.ts", "TypeScript", 12, 0, 2, 3, 17
"Total", "-", 3602, 1428, 173, 743, 5946